NO 	textures/redbrick.xpm
SO 	textures/purplestone.xpm
WE 	textures/mossy.xpm
EA  textures/wood.xpm
 
C 225,30,0
F 220,100,0
 
1111111111111111
1010000000000001
1010000000000001
1010000000000001
10000000E0000001
1000010000000001
1000000000000001
1000000000000001
1000000000000001
1100000000000011
1110000000000001
1110000000000001
1110000000000001
1110000000000001
1110000000000001
1111111111111111
