NO ./path_to_the_north_texture
SO ./path_to_the_south_texture
WE ./path_to_the_west_texture
EA textures/wood.xpm
 
F 220,100,0
C 225,30,0
 
11111111
10100001
10100101
10100001
10001001
10000101
10000001
11111111