NO 	textures/redbrick.xpm
SO 	textures/purplestone.xpm
WE 	textures/mossy.xpm
EA  textures/wood.xpm
 
C 225,30,0
F 220,100,0
 
1111111111111111111
1010000000000001001
1010000000000001001
1010000000011111001
1000000000000001001
1000010000000110001
100000000N000000111
1000000000000000111
1000001111111110001
1100000000000000011
1110000000100111111
1110000000100000001
1111110111100000001111111
1110000100100001001
1110000000000001001
1111111111111111111
1
1
1
1
1
1
11111111